You have been unconscious for a very long time and suddenly you wake up to find yourself in the middle of the hall.

You remember that you went out with your friends to a party last night and had so much fun. You and your friends were drunk. There is a haunted house in your neighborhood. All of you had a conversation about that haunted house on the way back to home after the party. That is all you can remember. You have no idea how you ended up alone in this hall.

You realise that you are in that haunted house in your neighborhood that you talked about last night with your friends. All you want is to get out of this haunted house alive.

Escape Room
An Interactive Fiction by Ruiwen, Kavita, Reetu, Himani, Akash
Release 1 / Serial number 201111 / Inform 7 build 6M62 (I6/v6.33 lib 6/12N) SD

Hall
You see that it is very dark and spooky. It is bloody everywhere. Flickering chandelier with broken strings of crystals swinging in the air. You want to get out of this haunted house alive as soon as possible.

You see a locked magic door, you try opening the door, but it is locked. You notice that the door has five keyholes with different colors. You look around more and also see five doors: Reddoor, Yellowdoor, Bluedoor, Greendoor and Purpledoor with colors corresponding to the color of the keyholes of the magic door.

>take keys
You can't see any such thing.

>take red
You can't see any such thing.

>take redkey
Taken.

>take yellowkey
Taken.

>take bluekey
Taken.

>take greenkey
Taken.

>take purplekey
Taken.

>open magic door
You are still missing something to open the door!

    *** A screeching sound alarms you! You turn around and watch a message getting carved into the marble floor: "Finally order is restored". This place is officially haunted.....    the end!  ***

Would you like to RESTART, RESTORE a saved game, QUIT or UNDO the last command?

>restart
Three weeks ago, you asked your friend to come up with rooming accommodations for your trip to the mountains. He assured you that the place he picked was of the highest quality, and the pictures of it look amazing. There's a couple weird reviews online about objects moving unassisted and other mysterious occurrences, but you don't believe any of that nonsense. 
Escape Room
An Interactive Fiction by Ruiwen, Kavita, Reetu, Himani, Akash
Release 1 / Serial number 201108 / Inform 7 build 6M62 (I6/v6.33 lib 6/12N) SD

main room
When you enter the house, you notice it used to be a magnificent and luxurious lobby but now it is bloody everywhere. Flickering chandelier with broken strings of crystals is swinging in the air. You look around and find five magic doors floating in the air: Red room, Yellow room, Blue room,Green room and Purple room. When you look back at where you come from, you find a locked magic door with five keyholes with different colors corresponding with the color of magic doors. 

You can see a redkey, a yellowkey, a bluekey, a greenkey and a purplekey here.

>take yellowkey
Taken.

>open magic door
You are still missing something to open the door!

It seems to be locked.

* * *

>x Red
You see nothing special about the Red.

* * *

>open Purple door
It seems to be locked.

* * *

>open Purple
purple room
Thick cobwebs fill the corners of the room, and wisps of webbing hang from the ceiling and waver in a wind you can barely feel. The rats inside the room shriek when they hear the door open and then they run in all directions from a putrid corpse lying on the floor. The reek of the room assaults your nose. The dusty floor shows that the room was deserted from a long time. The walls are covered with blood marks and filled with cracks. You can see the skeleton of some humanoid impaled on the wall.

The room seems to be the kitchen of the haunted house.  It has a purple door on its east through which you have entered. The room contains a rotting wooden cupboard, a greasy and mucky stove, a dirty oven, a huge refrigerator and a rusted sink.

You hear an ear-splitting screech and the door slams shut. Apparently, somebody doesn't want you to go out of this room. The entry and exit of this room is only through the purple door. You need to get out of this room as soon as possible.

>open oven
You can just barely perceive a lump about the size of a human hand lying in the oven. Neither light nor darkvision can penetrate the gloom in this oven.

You also see a plastic key at the corner of the oven.

>take key
Taken.

>open frig
You can't see any such thing.

>open fridge
You open the refrigerator.

It is filled with remains, dirt and some food.

Inside the refrigerator, there is a freezer compartment at the top. At the bottom, there is a crisper drawer.

>open freezer
You open the freezer, revealing an ice block.

>take
What do you want to take?

>take ice
Taken.

>oven dryer
That's not a verb I recognise.

>open drawer
You open crisper drawer, revealing a watermelon.

>take watermelon
Taken.

>x stove
It is a filthy and greasy stove and seems like it still works. It has a grimy knob to turn on and trun off the heat.

>turn on knob
You turn on the knob.

>put ice block on stove
The ice block has melted from the heat of the burner. Now, you can see a wooden key on the stove top.

>take key
(the wooden key)
Taken.

>open cupboard
You open the cupboard, revealing a knife.

>take knife
Taken.

>cut watermelon
You cut the watermelon, then blood starts oozing out of it as if the watermelon was filled with blood, revealing a bloody key.

>x sink
It is a rusted metal sink filled with remains. It has a faucet and a smelly drain.

>switch on faucet
You turn on faucet and dirty water is flowing from it.

>take bloody key
The pieces of watermelon have magically disappeared now

>x bloody key
It is in bright red color and wet with blood on it. You are unable to see its actual color.

>wash bloody key
What do you want to wash the bloody key with?

>wash bloody key with water
You wash the bloody key with water, revealing its actual color purple. Finally, you have found the purple key.

>open purple door
You open the purple door.

Finally, you got out of this room alive. But be careful and remember that you are in a haunted house. You can be trapped in any of the rooms here forever.

main room
You notice it used to be a magnificent and luxurious lobby but now it is bloody everywhere. Flickering chandelier with broken strings of crystals is swinging in the air. You look around and find five magic doors floating in the air: Red door, Yellow door, Blue door,Green door and Purple. When you look back at where you come from, you find a locked magic door with five keyholes with different colors corresponding with the color of magic doors. 

You can see a redkey, a yellowkey, a bluekey, a greenkey and a purplekey here.

* * *

>open bluedoor
blue room
You are entering the dining room. The room has a huge Dining table in the center with twelve chairs kept around it. There are blood stains all over the place. The room has some utensils scattered on the floor.  On the right wall, there is a window that has blue curtains.  There are few old photographs on the left wall. The room looks unorganized. There is a small Wash basin on the left wall. You turn around and the blue door disappears. Now you need to find the Blue key to exit this room. There is a blue door.

On Wash basin is Mirror.

>open drawer
You open Drawer, revealing bluekey.

>take bluekey
Taken.

>open the blue door
It seems to be locked.

* * *

>open bluedoor
blue room
You are entering the dining room. The room has a huge Dining table in the center with twelve chairs kept around it. There are blood stains all over the place. The room has some utensils scattered on the floor.  On the right wall, there is a window that has blue curtains.  There are few old photographs on the left wall. The room looks unorganized. There is a small Wash basin on the left wall. You turn around and the blue door disappears. Now you need to find the Blue key to exit this room. There is a blue door.

On Wash basin is Mirror.

>open bluedrawer
You open BlueDrawer, revealing bluekey.

>take bluekey
Taken.

>unlock blue door with bluekey
You unlock blue door.

>open blue door
main room
You notice it used to be a magnificent and luxurious lobby but now it is bloody everywhere. Flickering chandelier with broken strings of crystals is swinging in the air. You look around and find five magic doors floating in the air: Reddoor, Yellowdoor, Bluedoor, Greendoor and Purpledoor. When you look back at where you come from, you find a locked magic door with five keyholes with different colors corresponding with the color of magic doors.

* * *

>take bluekey
Taken.

>open blue door
main room
You notice it used to be a magnificent and luxurious lobby but now it is bloody everywhere. Flickering chandelier with broken strings of crystals is swinging in the air. You look around and find five magic doors floating in the air: Reddoor, Yellowdoor, Bluedoor, Greendoor and Purpledoor. When you look back at where you come from, you find a locked magic door with five keyholes with different colors corresponding with the color of magic doors. 

You can't reach into the blue room.

>open greendoor
Green room
You now enter the Study room. The room is dimly lit with a candle chandelier and a fireplace but you can see pretty much clearly. There is a big wooden study desk in the center of the room. The wall behind the desk has a painting with curtains hanging from the sides that puddle on the carpet. The wall opposite to the fireplace is covered with floor-to-ceiling bookshelves.

>open blue drawer
You open the blue drawer, revealing a pair of gloves.

>take gloves
Taken.

>open box
You can't see any such thing.

>pour dirty-water into fire
You can see a jewelry box inside the fireplace.

>open box
You open the jewelry box, revealing a green stone.

>take stone
Taken.

>put green stone on painting
A green book falls down on the floor from the bookshelf.

* * *

>x purpledoor
It is an icky door made up of rotting wood and is in dark reddish-purple color as if painted with blood.

It seems you will be transfer to another room after opening this door. Are you sure to open it?

>x purple door
You can't see any such thing.

* * *

>x yellowdoor
It is a spooky door, behind the door seems a game room of the house.

It seems you will be transfer to another room after opening this door. Are you sure to open it?

* * *

>open greendoor
Study Room
You now enter the study room. The room is dimly lit with a candle chandelier and a fireplace but you can see pretty much clearly. There a big wooden study desk in the center of the room. The wall behind the desk has a painting with curtains hanging from the sides that puddle on the carpet. The wall opposite to the fireplace is covered with floor-to-ceiling bookshelves.

>x desk
It is an antique mahogany study desk. There is a note and a quill pen and an ink bottle. 
There are three drawers on one side. Red drawer on the top, blue in the middle and a yellow one at the bottom.

>open blue drawer
You open the blue drawer, revealing a pair of gloves.

* * *

>take gloves
Taken.

>x fire
It is an old wood-fired fireplace made from red brick. There is an armchair with an ottoman near the fireplace.

In the fireplace is a jewelery box.

>x fireplace
It is an old wood-fired fireplace made from red brick. There is an armchair with an ottoman near the fireplace.

In the fireplace is a jewelery box.

* * *

>open greendoor
Study Room
You now enter the study room. The room is dimly lit with a candle chandelier and a fireplace but you can see pretty much clearly. There a big wooden study desk in the center of the room. The wall behind the desk has a painting with curtains hanging from the sides that puddle on the carpet. The wall opposite to the fireplace is covered with floor-to-ceiling bookshelves.

>x fire
It is an old wood-fired fireplace made from red brick. There is an armchair with an ottoman near the fireplace.

>x ottomen
You can't see any such thing.

>x ottoman
It has delicately carved wooden legs with a cushioned leather covering. On top of it is a water jug.

>take jug
Taken.

>pour water into fire
You can't see any such thing.

>pour dirty-water into fire
You can see a jewelery box inside the fireplace.

>take jewelery
The box must be burning hot. You don't want to hurt your hands.

>open blue drawer
You open the blue drawer, revealing a pair of gloves.

* * *

>take gloves
Taken.

>take jewelery
Your hand feels warm under the hot jeweley box. Surprisingly, it is not burnt.

Taken.

>open box
You open the jewelery box, revealing a green stone.

>take stone
Taken.

>put stone in painting
That can't contain things.

>put stone on painting
A green book falls down on the floor from the bookshelf.

>open green book
You open the green book, revealing a greenkey.

>take greenkey
Taken.

>open green door
It seems to be locked.

>unlock green door
What do you want to unlock the Green door with?

>unlock green door with greenkey
You unlock the Green door.

>open green door
You open the Green door.

* * *

>open greendoor
Study Room
You now enter the study room. The room is dimly lit with a candle chandelier and a fireplace but you can see pretty much clearly. There a big wooden study desk in the center of the room. The wall behind the desk has a painting with curtains hanging from the sides that puddle on the carpet. The wall opposite to the fireplace is covered with floor-to-ceiling bookshelves.

>open blue drawer
You open the blue drawer, revealing a pair of gloves.

* * *

>take gloves
Taken.

>take jug
Taken.

>pour dirty-water into fire
You can see a jewelery box inside the fireplace.

>open box
You open the jewelery box, revealing a green stone.

* * *

>take stone
Taken.

>put stone on painting
A green book falls down on the floor from the bookshelf.

>open book
You open the green book, revealing a greenkey.

>take greenkey
Taken.

* * *

>open green door
It seems to be locked.

>unlock green door with greenkey
You unlock the Green door.

* * *

>south
You can't, since the Green door leads nowhere.

>x greenkey
It is an old wooden key painted in Emerald green.

>i
You are carrying:
  a greenkey
  a jug
  a pair of gloves

>open green door
That's already open.

>close green door
You close the Green door.

* * *

>close the green door
You close the Green door.

* * *

>take stone
Taken.

>put stone on paintin
You can't see any such thing.

>put stone on painting
A green book falls down on the floor from the bookshelf.

* * *

>open green door
It seems to be locked.

>open green door
It seems to be locked.

>move to main room
You can't see any such thing.

>restart
Are you sure you want to restart?

>y
You have been unconscious for a very long time and suddenly you wake up to find yourself in the middle of the hall. You look around to see that it is very dark and spooky. You realise that you need to get out of the house as soon as possible before you get possessed.

Escape Room
An Interactive Fiction by Ruiwen, Kavita, Reetu, Himani, Akash
Release 1 / Serial number 201108 / Inform 7 build 6M62 (I6/v6.33 lib 6/12N) SD

main room
You notice it used to be a magnificent and luxurious lobby but now it is bloody everywhere. Flickering chandelier with broken strings of crystals is swinging in the air. You look around and find five magic doors floating in the air: Reddoor, Yellowdoor, Bluedoor, Greendoor and Purpledoor. When you look back at where you come from, you find a locked magic door with five keyholes with different colors corresponding with the color of magic doors.

>open blue door
You can't see any such thing.

>open bluedoor
blue room
You are entering the dining room. The room has a huge Dining table in the center with twelve chairs kept around it. There are blood stains all over the place. The room has some utensils scattered on the floor.  On the right wall, there is a window that has blue curtains.  There are few old photographs on the left wall. The room looks unorganized. There is a small Wash basin on the left wall. You turn around and the blue door disappears. Now you need to find the Blue key to exit this room. There is a blue door.

On Wash basin is Mirror.

* * *

>take bluekey
Taken.

>open blue door
It seems to be locked.

>unlock blue door with bluekey
You unlock blue door.

* * *

>restart
Are you sure you want to restart?

* * *

>open purpledoor
purple room
Thick cobwebs fill the corners of the room, and wisps of webbing hang from the ceiling and waver in a wind you can barely feel. The rats inside the room shriek when they hear the door open and then they run in all directions from a putrid corpse lying on the floor. The reek of the room assaults your nose. The dusty floor shows that the room was deserted from a long time. The walls are covered with blood marks and filled with cracks. You can see the skeleton of some humanoid impaled on the wall.

The room seems to be the kitchen of the haunted house.  It has a purple door on its east through which you have entered. The room contains a rotting wooden cupboard, a greasy and mucky stove, a dirty oven, a huge refrigerator and a rusted sink.

You hear an ear-splitting screech and the door slams shut. Apparently, somebody doesn't want you to go out of this room. The entry and exit of this room is only through the purple door. You need to get out of this room as soon as possible.

>test play
(Testing.)

>[1] x oven
It is a dirty oven. You can hear an angry churring, punctuated with little squeaks from the oven. It can either be rats feeding on some remains or a ghost.

>[2] open oven
You can just barely perceive a lump about the size of a human hand lying in the oven. Neither light nor darkvision can penetrate the gloom in this oven.

You also see a plastic key at the corner of the oven.

>[3] take key
Taken.

>[4] open fridge
You open the refrigerator.

It is filled with remains, dirt and some food.

Inside the refrigerator, there is a freezer compartment at the top. At the bottom, there is a crisper drawer.

>[5] open freezer
You open the freezer, revealing an ice block.

>[6] take ice block
Taken.

>[7] turn on knob
You turn on the knob.

>[8] put ice on stove
The ice block has melted from the heat of the burner. Now, you can see a wooden key on the stove top.

>[9] take key
(the wooden key)
Taken.

>[10] open cupboard
You open the cupboard, revealing a knife.

>[11] take knife
Taken.

>[12] open crisper drawer
You open crisper drawer, revealing a watermelon.

>[13] take watermelon
Taken.

>[14] cut watermelon
You cut the watermelon, then blood starts oozing out of it as if the watermelon was filled with blood, revealing a bloody key.

>[15] take bloody  key
The pieces of watermelon have magically disappeared now
>[16] turn on faucet
You turn on faucet and dirty water is flowing from it.

>[17] wash bloody key with water
You wash the bloody key with water, revealing its actual color purple. Finally, you have found the purple key.

>[18] open purple door
You open the purple door.

Finally, you got out of this room alive. But be careful and remember that you are in a haunted house. You can be trapped in any of the rooms here forever.

main room
You notice it used to be a magnificent and luxurious lobby but now it is bloody everywhere. Flickering chandelier with broken strings of crystals is swinging in the air. You look around and find five magic doors floating in the air: Reddoor, Yellowdoor, Bluedoor, Greendoor and Purpledoor. When you look back at where you come from, you find a locked magic door with five keyholes with different colors corresponding with the color of magic doors.

* * *

>open box
You open the jewelery box, revealing a green stone.

>take green stone
Taken.

>put stone on painting
A green book falls down on the floor from the bookshelf.

* * *

>unlock green door with greenkey
You unlock the Green door.

>open green door
main room
You notice it used to be a magnificent and luxurious lobby but now it is bloody everywhere. Flickering chandelier with broken strings of crystals is swinging in the air. You look around and find five magic doors floating in the air: Reddoor, Yellowdoor, Bluedoor, Greendoor and Purpledoor. When you look back at where you come from, you find a locked magic door with five keyholes with different colors corresponding with the color of magic doors.

* * *

>open yellow door
You can't see any such thing.

>open yellowdoor
yellow room
You can see a yellow wall with the blood stained writing saying : Welcome to the game room you are stuck with your games and the only way out is to find the elusive yellow key.

You can see red water on the floor and a yellow door on the north to exit to the red room.

There are a lot of spooky toys around and a rocky chair.

You can see a yellow cabinet and a yellow fire place.

* * *

>open red door
You can't see any such thing.

>open reddoor
red room
After you walk through the red door, everything suddenly changed, the light starts to flash and finally shut off.

The last thing you see is a flashlight on your right handside.

Now you can't see anything.

You feel some liquid is rising and wet you ankle.

The feel tells you it definitly not water

>take flashlight
The flashlight turns on and lights up a dark red nightstand.

>x nightstand
A dark red nightstand, it seems some sticky red liquid dried to make it dark red.

In the red nightstand is a notebook.

>x notebook
An old notebook, probably belongs to the owner of the house.

>open notebook
"Run! Run! They are coming!"

You feel the liquid rise more, now it's about your knee.

You scared, turn the flashlight on the another side, light up a studydesk.

>close notebook
You close the notebook.

>open notebook
"Run! Run! They are coming!"

You feel the liquid rise more, now it's about your knee.

You scared, turn the flashlight on the another side, light up a studydesk.

>x studydesk
A desk with all scratches on it, there is a tiny notes sticked on the top-right corner.

On the studydesk is a notes.

>x notes
"Take me with you. I'll help you out!"

>take notes
You take the notes into your pocket.

Immediately, the liquid rises more, it covers over your neck and you start to feel hard to breath.

You lift the flashlight over your head and light up the bloody ceiling.

The light can only light up a small piece of the ceiling, you take a close look of the ceiling and find a engraved sentences which looks like scratched by someone.

"Put the notes on chanderlier!"

>x chanderlier
You see nothing special about the chanderlier.

>put notes on chanderlier
The liquid finally covers your head, you lost your consciousness......

......

You wake up in the main room, and you find you are grabbing a redkey instead of a flashlight.

main room
You notice it used to be a magnificent and luxurious lobby but now it is bloody everywhere. Flickering chandelier with broken strings of crystals is swinging in the air. You look around and find five magic doors floating in the air: Reddoor, Yellowdoor, Bluedoor, Greendoor and Purpledoor. When you look back at where you come from, you find a locked magic door with five keyholes with different colors corresponding with the color of magic doors.

>i
You are carrying:
  a redkey
  a flashlight

* * *

>open reddoor
red room
After you walk through the red door, everything suddenly changed, the light starts to flash and finally shut off.

The last thing you see is a flashlight on your right handside.

Now you can't see anything.

You feel some liquid is rising and wet you ankle.

The feel tells you it definitly not water

>take flashliht
You can't see any such thing.

>take flashlight
The flashlight turns on and lights up a dark red nightstand.

>open nightstand
That's already open.

>close nightstand
You close the red nightstand.

>open nightstand
You open the red nightstand, revealing a notebook.

>x nightstand
A dark red nightstand, it seems some sticky red liquid dried to make it dark red.

In the red nightstand is a notebook.

>open notebook
"Run! Run! They are coming!"

You feel the liquid rise more, now it's about your knee.

You scared, turn the flashlight on the another side, light up a studydesk.

>take note
You can't see any such thing.

>take notes
You take the notes into your pocket.

Immediately, the liquid rises more, it covers over your neck and you start to feel hard to breath.

You lift the flashlight over your head and light up the bloody ceiling.

The light can only light up a small piece of the ceiling, you take a close look of the ceiling and find a engraved sentences which looks like scratched by someone.

"Put the notes on chanderlier!"

>put notes on chanderlier
The liquid finally covers your head, you lost your consciousness......

......

You wake up in the main room, and you find you are grabbing a redkey instead of a flashlight.

main room
You notice it used to be a magnificent and luxurious lobby but now it is bloody everywhere. Flickering chandelier with broken strings of crystals is swinging in the air. You look around and find five magic doors floating in the air: Reddoor, Yellowdoor, Bluedoor, Greendoor and Purpledoor. When you look back at where you come from, you find a locked magic door with five keyholes with different colors corresponding with the color of magic doors.

>open yellowdoor
yellow room
You can see a yellow wall with the blood stained writing saying : Welcome to the game room you are stuck with your games and the only way out is to find the elusive yellow key.

You can see red water on the floor and a yellow door on the north.

There are a lot of spooky toys around and a rocky chair.

You can see a yellow cabinet and a yellow fire place.

>take stone / x letter / throw stone in fire
You can't see any such thing.

>take stone
You can't see any such thing.

>open cabinet / take stone / x letter / throw stone in fire / look under cabinet
I only understood you as far as wanting to open the yellow cabinet.

>take stone
You can't see any such thing.

>open cabinet
You open the yellow cabinet, revealing a yellow stone and a letter.

>take stone
Taken.

>throw stone in fire
Now that the you have thrown the stone into the fire, you see a huge light come up and a lot of sparkles. Oh my god there is yellow key that is thrown out straight under the cabinet.

>look under cabinet
You have the yellow key now. Get out as soon as possible.

>open yellow door
main room
You notice it used to be a magnificent and luxurious lobby but now it is bloody everywhere. Flickering chandelier with broken strings of crystals is swinging in the air. You look around and find five magic doors floating in the air: Reddoor, Yellowdoor, Bluedoor, Greendoor and Purpledoor. When you look back at where you come from, you find a locked magic door with five keyholes with different colors corresponding with the color of magic doors. 

You can't reach into the yellow room.

>open bluedoor
blue room
You are entering the dining room. The room has a huge Dining table in the center with twelve chairs kept around it. There are blood stains all over the place. The room has some utensils scattered on the floor.  On the right wall, there is a window that has blue curtains.  There are few old photographs on the left wall. The room looks unorganized. There is a small Wash basin on the left wall. You turn around and the blue door disappears. Now you need to find the Blue key to exit this room. There is a blue door.

On Wash basin is Mirror.

* * *

>open blue door
main room
You notice it used to be a magnificent and luxurious lobby but now it is bloody everywhere. Flickering chandelier with broken strings of crystals is swinging in the air. You look around and find five magic doors floating in the air: Reddoor, Yellowdoor, Bluedoor, Greendoor and Purpledoor. When you look back at where you come from, you find a locked magic door with five keyholes with different colors corresponding with the color of magic doors. 

You can't reach into the blue room.

>open green door
You can't see any such thing.

>open greendoor
Green room
You now enter the Study room. The room is dimly lit with a candle chandelier and a fireplace but you can see pretty much clearly. There is a big wooden study desk in the center of the room. The wall behind the desk has a painting with curtains hanging from the sides that puddle on the carpet. The wall opposite to the fireplace is covered with floor-to-ceiling bookshelves.

>x desk
It is an antique mahogany study desk. There is a note and a quill pen and an ink bottle. 
There are three drawers on one side. Red drawer on the top, blue in the middle and a yellow one at the bottom.

>x note
An element of Ancient Greeks
Has many tongues but never speaks
Where this glowing beast resides
Is where you'll find a clue to survive

>pour dirty-water into fireplace
You can see a jewelry box inside the fireplace.

>open box
You open the jewelry box, revealing a green stone.

* * *

>restart
You have been unconscious for a very long time and suddenly you wake up to find yourself in the middle of the hall.

You remember that you went out with your friends to a party last night and had so much fun. You and your friends were drunk. There is a haunted house in your neighborhood. All of you had a conversation about that haunted house on the way back to home after the party. That is all you can remember. You have no idea how you ended up alone in this hall.

You realise that you are in that haunted house in your neighborhood that you talked about last night with your friends. All you want is to get out of this haunted house alive.

Escape Room
An Interactive Fiction by Ruiwen, Kavita, Reetu, Himani, Akash
Release 1 / Serial number 201111 / Inform 7 build 6M62 (I6/v6.33 lib 6/12N) SD

Hall
You see that it is very dark and spooky. It is bloody everywhere. Flickering chandelier with broken strings of crystals swinging in the air. You want to get out of this haunted house alive as soon as possible.

You see a locked magic door, you try opening the door, but it is locked. You notice that the door has five keyholes with different colors. You look around more and also see five doors: Reddoor, Yellowdoor, Bluedoor, Greendoor and Purpledoor with colors corresponding to the color of the keyholes of the magic door.

>x reddoor
It seems the most normal and clearest door among others, look through the door you find a normal master bedroom.

You never know what might happen once you enter this room.

>open reddoor
red room
After you walk through the red door, everything suddenly changed, the light starts to flash and finally shut off.

The last thing you see is a flashlight on your right handside.

Now you can't see anything.

You feel some liquid is rising and wet you ankle.

The feel tells you it definitly not water

Remember: You can always use x (item) to examine, take (item) to take, put (item) in/on (item) to put.

>take flashlight
The flashlight turns on and lights up a dark red nightstand.

>x nightstand
A dark red nightstand, it seems some sticky red liquid dried to make it dark red.

>open nightstand
You open the red nightstand, revealing a notebook.

>open notebook
"Run! Run! They are coming!"

You feel the liquid rise more, now it's about your knee.

You scared, turn the flashlight on the another side, light up a studydesk.

* * *

>take notes
You take the notes into your pocket.

Immediately, the liquid rises more, it covers over your neck and you start to feel hard to breath.

You lift the flashlight over your head and light up the bloody ceiling.

The light can only light up a small piece of the ceiling, you take a close look of the ceiling and find a engraved sentences which looks like scratched by someone.

"Put the notes on chanderlier!"

>put the notes on chanderlier
The liquid finally covers your head, you lost your consciousness......

......

You wake up in the Hall, and you find you are grabbing a redkey instead of a flashlight.

Hall
You see that it is very dark and spooky. It is bloody everywhere. Flickering chandelier with broken strings of crystals swinging in the air. You want to get out of this haunted house alive as soon as possible.

You see a locked magic door, you try opening the door, but it is locked. You notice that the door has five keyholes with different colors. You look around more and also see five doors: Reddoor, Yellowdoor, Bluedoor, Greendoor and Purpledoor with colors corresponding to the color of the keyholes of the magic door.

>open yellowdoor
yellow room
You can see a yellow wall with the blood stained writing saying : Welcome to the game room you are stuck with your games and the only way out is to find the elusive yellow key.

You can see red water on the floor and a yellow door on the north.

There are a lot of spooky toys around and a rocky chair.

You can see a yellow cabinet and a yellow fire place.

>open yellow cabinet
You open the yellow cabinet, revealing a yellow stone and a letter.

>take stone
Taken.

>x letter
You have the stone in your sights, yeasss. Well maybe you could throw it into the fire? Lets see how that goes and if you gonna be alive at the end of it

>throw stone in fire
Now that the you have thrown the stone into the fire, you see a huge light come up and a lot of sparkles. Oh my god there is yellow key that is thrown out straight under the cabinet.

* * *

>look under cabinet
You have the yellow key now. Get out as soon as possible.

>open the yellow door
Hall
You see that it is very dark and spooky. It is bloody everywhere. Flickering chandelier with broken strings of crystals swinging in the air. You want to get out of this haunted house alive as soon as possible.

You see a locked magic door, you try opening the door, but it is locked. You notice that the door has five keyholes with different colors. You look around more and also see five doors: Reddoor, Yellowdoor, Bluedoor, Greendoor and Purpledoor with colors corresponding to the color of the keyholes of the magic door.

You can't reach into the yellow room.

>open bluedoor
blue room
You are entering the dining room. The room has a huge Dining table in the center with twelve chairs kept around it. There are blood stains all over the place. The room has some utensils scattered on the floor.  On the right wall, there is a window that has blue curtains.  There are few old photographs on the left wall. The room looks unorganized. There is a small Wash basin on the left wall. You turn around and the blue door disappears. Now you need to find the Blue key to exit this room. There is a blue door.

>x wash basin
It is a huge marble basin with an old tap from which red colored water is dripping slowly.  There is a Mirror on top of it  that has dried blood stains. There is a  wooden BlueDrawer below the basin.

>x mirror
It is a huge broken mirror  with wooden frame. There is a hanging paper on the mirror.

>x paper
It is an old paper with burnt edges.

>read paper
It is an old paper with burnt edges.

>take paper
Taken.

>open paper
You sit here when you want to eat food keep your elbows off you don't want to be rude.

You open paper.

>x dining table
It is an old huge wooden table. It has some scratches on it and some blood stains. There is big tea pot on the dining table. The dining table has some mud on it.

>x mud
The mud is dry and similar to beach sand in texture. Below the mud, there is a story book.

In mud is story book.

>open book
You open story book.

>open story book
That's already open.

>take story book
Taken.

>open story book
What starts with a t, ends with a t and is full of t?

That's already open.

>x tea pot
It is an antique design pot. It looks pretty old and a bit broken. It has a shining golden design that looks faded with time.

>open tea pot
You open tea pot, revealing drawerkey.

>take drawerkey
Taken.

>open bluedrawer
It seems to be locked.

>open bluedrawer with drawerkey
You unlock BlueDrawer.

>x bluedrawer
It is a small wooden drawer that can be pulled to keep things inside.  You need to find drawerkey to open the bluedrawer. You will find clue to the main door's bluekey inside the drawer.

>open bluedrawer
You open BlueDrawer, revealing bluekey.

* * *

>take bluekey
Taken.

>open blue door
Hall
You see that it is very dark and spooky. It is bloody everywhere. Flickering chandelier with broken strings of crystals swinging in the air. You want to get out of this haunted house alive as soon as possible.

You see a locked magic door, you try opening the door, but it is locked. You notice that the door has five keyholes with different colors. You look around more and also see five doors: Reddoor, Yellowdoor, Bluedoor, Greendoor and Purpledoor with colors corresponding to the color of the keyholes of the magic door.

You can't reach into the blue room.

>open greendoor
Green room
You now enter the Study room. The room is dimly lit with a candle chandelier and a fireplace but you can see pretty much clearly. There is a big wooden study desk in the center of the room. The wall behind the desk has a painting with curtains hanging from the sides that puddle on the carpet. The wall opposite to the fireplace is covered with floor-to-ceiling bookshelves.

You hear a loud THUD! The door is slammed shut and now you are trapped inside. A voice says, "FIND THE KEY!"

>x desk
It is an antique mahogany study desk. There is a note and a quill pen and an ink bottle. 
There are three drawers on one side. Red drawer on the top, blue in the middle and a yellow one at the bottom.

* * *

>x note
An element of Ancient Greeks
Has many tongues but never speaks
Where this glowing beast resides
Is where you'll find a clue to survive

>open fire
It isn't something you can open.

>x fire
It is an old wood-fired fireplace made from red brick. There is an armchair with an ottoman near the fireplace.

>x ottoman
It has delicately carved wooden legs with a cushioned leather covering. On top of it is a jug.

>x jug
It is made out of glass and is filled with dirty-water. It is inscribed with "ruop retaw-ytrid otni ecalperif".

>take jug
Taken.

>pour dirty-water into fireplace
You can see a jewelry box inside the fireplace.

* * *

>open box
You open the jewelry box, revealing a green stone.

>take green stone
Taken.

>x painting
It is an oil painting of an old woman with pale wrinkled skin and an evil smile. You feel like she is staring at you. You notice that one of her eyes has a green stone on it but the other is missing.

>put green stone on painting
A green book falls down on the floor from the bookshelf.

>open green book
You open the green book, revealing a greenkey.

* * *

>take greenkey
Taken.

>open green door
You are finally out of the room now.

Hall
You see that it is very dark and spooky. It is bloody everywhere. Flickering chandelier with broken strings of crystals swinging in the air. You want to get out of this haunted house alive as soon as possible.

You see a locked magic door, you try opening the door, but it is locked. You notice that the door has five keyholes with different colors. You look around more and also see five doors: Reddoor, Yellowdoor, Bluedoor, Greendoor and Purpledoor with colors corresponding to the color of the keyholes of the magic door.

You can't reach into the Green room.

>open purpledoor
purple room
Thick cobwebs fill the corners of the room, and wisps of web hang from the ceiling. The rats inside the room shriek when they hear the door open and then they run in all directions from a putrid corpse lying on the floor. The reek of the room inflames your nose. The dusty floor shows that the room was deserted from a long time. The walls are covered with blood marks and filled with cracks. You can see the skeleton of some humanoid impaled on the wall.

The room seems to be the kitchen of the haunted house.  It has a purple door on its east through which you have entered. The room contains a rotting wooden cupboard, a greasy and mucky stove, a dirty oven, a huge refrigerator and a rusted sink.

You hear an ear-splitting screech and the door slams shut. Apparently, somebody doesn't want you to go out of this room. The entry and exit of this room is only through the purple door. You need to get out of this room as soon as possible.

>x oven
It is a dirty oven. You can hear an angry chirring, punctuated with little squeaks from the oven. It can either be rats feeding on some remains or a ghost.

>open oven
You can just barely perceive a lump about the size of a human hand lying in the oven. Neither light nor dark vision can penetrate the gloom in this oven.

You also see a plastic key at the corner of the oven.

>take plastic key
Taken.

>x fridge
It is a huge refrigerator that still seems to be working.

>unlock firdge with plastic key
You can't see any such thing.

>unlock fridge with plastic key
You unlock the refrigerator.

>open fridge
You open the refrigerator.

It is filled with remains, dirt and some food.

Inside the refrigerator, there is a freezer compartment at the top. At the bottom, there is a crisper drawer.

* * *

>open freezer
You open the freezer, revealing an ice block.

>take ice
(the ice block)
Taken.

>turn on knob
You turn on the knob.

>put ice on stove
(the ice block on stove)
The ice block has melted from the heat of the burner. Now, you can see a wooden key on the stove top.

>take key
(the wooden key)
Taken.

* * *

>take knife
Taken.

>open drawer
You open crisper drawer, revealing a watermelon.

* * *

>take watermelon
Taken.

>cut watermelon
You cut the watermelon, then blood starts oozing out of it as if the watermelon was filled with blood, revealing a bloody key.

>take key
(the bloody key)
The pieces of watermelon have magically disappeared now.

>turn on faucet
You turn on faucet and dirty water is flowing from it.

>wash bloody key with water
You wash the bloody key with water, revealing its actual color purple. Finally, you have found the purple key.

>open purple door
It seems to be locked.

>unlock purple door with purple key
I only understood you as far as wanting to unlock purple door with purple door.

>unlock purple door with purplekey
You unlock purple door.

>open purple door
You open the purple door.

Finally, you got out of this room alive. But be careful and remember that you are in a haunted house. You can be trapped in any of the rooms here forever.

Hall
You see that it is very dark and spooky. It is bloody everywhere. Flickering chandelier with broken strings of crystals swinging in the air. You want to get out of this haunted house alive as soon as possible.

You see a locked magic door, you try opening the door, but it is locked. You notice that the door has five keyholes with different colors. You look around more and also see five doors: Reddoor, Yellowdoor, Bluedoor, Greendoor and Purpledoor with colors corresponding to the color of the keyholes of the magic door.

>x magic door
It is a door which seems like a blackhole, blood dried on door frame.

It has five keyholes with five different colors, red, yellow, blue, gree and purple similar to the door colors of the 5 rooms in the house.

Start your search for the keys to escape this haunted house alive!

>open magic door
*** You open the door and walk through the blackhole.

Then, you wake up startled in your bed in your house.

You start to doubt if all of what just happened was a dream?

Suddenly, you find something clanging in your pocket,

..... the five keys!

The End!  ***

Would you like to RESTART, RESTORE a saved game, QUIT or UNDO the last command?

>restart
You have been unconscious for a very long time and suddenly you wake up to find yourself in the middle of the hall.

You remember that you went out with your friends to a party last night and had so much fun. You and your friends were drunk. There is a haunted house in your neighborhood. All of you had a conversation about that haunted house on the way back to home after the party. That is all you can remember. You have no idea how you ended up alone in this hall.

You realise that you are in that haunted house in your neighborhood that you talked about last night with your friends. All you want is to get out of this haunted house alive.

Escape Room
An Interactive Fiction by Ruiwen, Kavita, Reetu, Himani, Akash
Release 1 / Serial number 201111 / Inform 7 build 6M62 (I6/v6.33 lib 6/12N) SD

Hall
You see that it is very dark and spooky. It is bloody everywhere. Flickering chandelier with broken strings of crystals swinging in the air. You want to get out of this haunted house alive as soon as possible.

You see a locked magic door, you try opening the door, but it is locked. You notice that the door has five keyholes with different colors. You look around more and also see five doors: Reddoor, Yellowdoor, Bluedoor, Greendoor and Purpledoor with colors corresponding to the color of the keyholes of the magic door.

>unlock magic door
What do you want to unlock the magic door with?